       11111 111  11   
      111111111111111  
      1111111111111111  
       111111111111111  
       111111111111111  
      111111111111111  
 111111111111111   1    
 1111111111        1    
 111111111         1    
 111   111   111111111 
 111   111111111111111 
 111   111   111111111 
 111111111   111111111 
 111111111111111111111 
 P11111111             
                        
23,16
